12
12
************
*_*_**_*___*
*__________*
*___**_*___*
*__________*
*__________*
*__________*
*__________*
*__________*
*__________*
*__________*
************