12
12
************
*ss111111ss*
*s111**111s*
*11*1111*11*
*1111111111*
*1111**1111*
*1111**1111*
*1111111111*
*11*1111*11*
*s111**111s*
*ss111111ss*
************