12
12
************
*ss111111ss*
*s1*1111*1s*
*1*111111*1*
*111*11*111*
*1111111111*
*1111111111*
*111*11*111*
*1*111111*1*
*s1*1111*1s*
*ss111111ss*
************