12
12
************
*ss111111ss*
*s*11**11*s*
*1111111111*
*1*11**11*1*
*1111111111*
*1111111111*
*1*11**11*1*
*1111111111*
*s*11**11*s*
*ss111111ss*
************